NO ./path_to_the_north_texture
SO ./path_to_the_south_texture
WE ./path_to_the_west_texture
EA ./path_to_the_east_texture

F 220,100,0
C 225,30,0

11111111111111111111111
1W000000000000000000001
10000010000010000000001
10000000000000000000001  
10000000110000000000001
1000100000010100000W001
11111111111111111111111