NO ./sprites/wall/wall-2.png
SO ./sprites/wall/wall-2.png
WE ./sprites/wall/wall-2.png
EA ./sprites/wall/wall-2.png

F 31,31,31
C 1,186,188

111111111111111111111111111111111111
100000000000000000000000000000000001
100000000001100000000000000000000001
100000000000000000000000000000000001
100111101101100111111000001111000001
100011101101100000001101100111000001
100001101101101111001100110011000001
100001101101101100011100011011000001
100000111111000111111000001110000001
100000000000000000000000000000000001
100011110111100011111000111100110001
100110011100110110001101110000110001
100110000000110000001100111000110001
100110110000110000001101110000110001
100011100001100000001100011111100001
100000000000000000000000000000000001
100000000000111111111110000000000001
100000000000011111111100000000000001
100000000000001111111000000000000001
10000000000000011N110000000000000001
100000000000000000000000000000000001
100000000000000111110000000000000001
111111111111111111111111111111111111
