NO ./sprites/wall/wall-2.png
SO ./sprites/wall/wall-2.png
WE ./sprites/wall/wall-2.png
EA ./sprites/wall/wall-2.png

F 31,31,31
C 1,186,188

        1111111111111111111111111
        1000000000110000000000001
        1011000001110000000000001
        1001000000000000000000001
1111111110110000011100000000000011111
100000000011000001110111111111111
111101111111110111000000000
111101111111110111010100100
110000001101010111000000100
10000000000000001100000010001
10000000000000000001010010001
11000001110101011111011110N0111
11110111 1110101 101111010001
11111111 1111111 11111111111111