NO ./path_to_the_north_texture
SO ./path_to_the_south_texture
WE ./path_to_the_west_texture
EA ./path_to_the_east_texture

F 220,100,0
C 225,30,0

11111111111111111111111
10000000000000000000001
10000010000010000000001
100000000000000000W0001  
10000000110000000000001
10001000000101000000001
10000000000000000000001