11111111111111111111111
10000000000000000000001
10000010000010000000001
10000000000000000000001  
10000000110000000000001
10001000000101000000001
11111111 11111111111111