NO ./sprites/wall/wolf-1.png
SO ./sprites/wall/wall-1.png
WE ./sprites/wall/wall-2.png
EA ./sprites/wall/lightwolf-1.png

F 220,100,0
C 225,30,0

        1111111111111111111111111
        1000000000110000000000001
        1011000001110000000000001
        10010000000000000000000011110
1111111110110000011100000000000011111
100000000011000001110111111111111
11110111111111011100000000001
11110111111111011101010010001
11000000110101011100000010001
10000000000000001100000010001
10000000000000000001010010001
11000001110101011111011110N0111
11110111 1110101 101111010001
11111111 1111111 11111111111111