NO ./sprites/wall/wall-1.png
SO ./sprites/wall/wall-1.png
WE ./sprites/wall/wall-1.png
EA ./sprites/wall/wall-1.png

F 31,31,31
C 1,186,188

        1111111111111111111111111
        100000000011000   0000001
        101100000111000   0000001
        100100000000000   0000001
1111111110110000011100000000000011111
100000000011000001110111111111111
11110111111111011100000000001
11110111111111011101010010001
11000000110101011100000010001
10 0000000000 001100000010001
1000000 000000000001010010001
11000001110101011111011110N0111
11110111 1110101 101111010001
11111111 1111111 11111111111111